-,-,-,-,-,-,-,-,-,-,-,-,-,-,-,-,-,-
-,-,-,-,-,-,-,-,-,-,-,-,-,-,-,-,-,-
-,-,-,-,-,-,-,-,-,-,-,-,-,-,-,-,-,-
-,-,-,-,-,1,1,1,1,1,1,1,1,1,-,-,-,-
-,-,-,-,-,1,-,-,-,-,-,-,-,1,-,-,-,-
-,-,-,-,-,1,-,-,-,-,-,-,-,1,-,-,-,-
-,-,-,-,-,1,-,-,1,1,1,1,-,1,-,-,-,-
-,-,-,-,-,1,-,-,1,-,-,1,-,1,-,-,-,-
-,-,-,-,-,1,-,-,1,-,A,1,-,1,-,-,-,-
-,-,-,-,-,1,-,-,1,A,-,1,-,1,-,-,-,-
-,-,-,-,-,1,-,-,1,-,-,1,-,1,-,-,-,-
-,-,A,-,-,-,-,-,1,-,A,1,-,1,-,-,-,-
-,-,-,-,-,-,-,-,1,-,-,1,-,1,-,-,-,-
-,-,-,-,-,-,-,-,1,-,-,-,-,1,-,-,-,-
-,-,-,A,-,-,-,-,1,1,1,1,1,1,-,-,-,-
-,-,-,-,-,-,-,-,-,-,-,-,-,-,-,-,-,-
-,-,-,-,-,-,-,-,-,-,-,-,-,-,-,-,-,-
-,-,-,-,-,-,-,-,-,-,-,-,-,-,-,-,-,-
-,-,-,-,-,-,-,-,-,-,-,-,-,-,-,-,-,-
-,-,-,-,-,-,-,-,-,-,-,-,-,-,-,-,-,-
-,-,-,1,-,-,-,-,-,-,-,-,-,-,-,-,-,-
-,-,-,-,-,-,-,-,-,-,-,-,-,-,-,-,-,-
-,-,-,-,-,-,-,-,-,-,-,-,-,-,-,-,-,-
-,-,-,-,-,-,-,-,-,-,-,-,-,-,-,-,-,-
-,SPAWN,-,-,-,-,-,-,-,-,-,-,-,-,-,-,-,-
-,-,-,-,-,-,-,-,-,-,-,-,-,-,-,-,-,-
-,-,-,-,-,-,-,-,-,-,-,-,-,-,-,-,-,-
