0,0,0,0,0,0,0,0,0,0,0,0,0,0,0,0,0,0,0,0
2,2,2,2,2,2,2,2,2,2,2,2,2,2,2,2,2,1,1,1
0,0,0,0,0,0,0,0,0,0,0,0,0,0,0,0,0,1,1,1
0,0,0,0,0,0,0,0,0,0,0,0,0,0,0,0,0,1,1,1
0,0,0,0,0,0,0,0,0,0,0,0,0,0,0,0,0,1,1,1
SPAWN,0,0,0,0,0,0,0,0,0,0,0,0,0,0,0,0,T0GT,0,EXIT
2,2,2,2,1,0,0,0,0,1,2,2,2,2,2,2,2,2,2,2
1,1,1,1,2,0,0,0,0,2,1,1,1,1,1,1,1,1,1,1
1,1,1,1,2,0,0,0,0,2,1,1,1,1,1,1,1,1,1,1
1,1,1,1,1,2,2,2,2,1,1,1,1,1,1,1,1,1,1,1
